khôg	không
mih	mình
nhữg	những
r	rồi
thươg	thương
chug	chung
trườg	trường
thoy	thôi
ạk	ạ
cùg	cùng
pn	bạn
pjt	biết
thjk	thích
nek	nè
chúg	chúng
kái	cái
tìh	tình
phòg	phòng
lòg	lòng
từg	từng
rằg	rằng
sốg	sống
thuj	thôi
thuơng	thương
càg	càng
bằg	bằng
ák	á
đág	đáng
nhjeu	nhiều
xg	xuống
zồi	rồi
trag	trang
zữ	dữ
độg	động
gắg	gắng
đồg	đồng
vọg	vọng
đôg	đông
răg	răng
thườg	thường
đứg	đứng
xuốg	xuống
nkư	như
tiếg	tiếng
hajz	hai
xih	xinh
hìh	hình
thàh	thành
ngke	nghe
dzậy	dậy
tưởg	tưởng
phog	phong
hôg	không
zìa	gì
kũg	cũng
trọg	trọng
năg	năng
riêg	riêng
ngag	ngang
ngốk	ngốc
kậu	cậu
địh	định
giốg	giống
xug	xùng
zùi	rồi
kòn	còn
buôg	buông
chàg	chàng
chăg	chăng
ngàh	ngành
nkưng	nhưng
nắg	nắng
tíh	tính
khoảg	khoảng
thík	thích
thẳg	thẳng
kảm	cảm
dàh	dành
júp	giúp
lặg	lặng
bóg	bóng
dòg	dòng
uốg	uống
tượg	tượng
qà	quà
thjc	thích
nhưq	nhưng
zà	già
đáh	đánh
zám	dám
bìh	bình
hajzz	hai
kủa	của
đóg	đóng
cka	cha
qả	quả
nèk	nè
òy	rồi
nặg	nặng
họk	học
dừg	dừng
lạh	lạnh
fây	phây
lúk	lúc
haj	hai
ngía	nghía
mớj	mới
điiiiiii	đi
rồii	rồi
c	chị
kih	kinh
hixxx	hích
nhiềuuu	nhiều
mìnk	mình
mjh	mình
ng	người
uhm	ừm
thỳ	thì
tks	thanks
nàg	nàng
thôii	thôi
đjên	điên
vớii	với
xink	xinh
mk	mình
bn	bạn
thik	thích
cj	chị
nguoi	người
nógn	nóng
hok	không
ko	không
bik	biết
vs	với
cx	cũng
mik	mình
đc	được
cmt	comment
ck	chồng
chk	chồng
oh	ồ
vk	vợ
ah	à
ạh	ạ
rì	gì
ms	mới
nhaa	nha
cũg	cũng
đag	đang
ơiii	ơi
hic	hích
àk	à
uh	ừ
ơiiii	ơi
ukm	ừm
đii	đi
trieu	triệu
ngèo	nghèo
kêh	kênh
ak	à
ad	admin
j	gì
dc	được
zui	vui
zẻ	vẻ
tym	tim
fb	facebook
insta	instagram
z	vậy
thich	thích
acc	account
lol	lồn
loz	lồn
lozz	lồn
trc	trước
qá	quá
wá	quá
zậy	vậy
zô	vô
face	facebook
ns	nói
iu	yêu
in4	info
sub	subcribe
kh	không
zạ	vậy
oy	rồi
jo	giờ
wa	quá
hjx	hix
e	em
ik	ý
ji	gì
lm	làm
sr	sorry
ib	inbox
hoy	thôi
k	không
a	anh
z   vậy
kô	không
xog	xong
uh	ừ
uk	ừ
nhoé	nhé
biet	biết
quí	quý
đươc	được
nghành	ngành
ngừoi	người
trog	trong
biêt	biết
fải	phải
nguời	người
khg	không
nhưg	nhưng
thằg	thằng
đuợc	được
dc	được
đc	được
ah	à
àh	à
ku	cu
thým	thím
onl	online
zô	dô
zú	vú
đc	được
ná	nhé
nhóe	nhé
đê	đi
wc	nvs
chòa	chào
líi	lý
lí	lý
kiểng	cảnh
xố	số
